####################
#O                 #
#                  #
#        P         #
#                  #
#         X        #
#                  #
#                  #
#                  #
####################